10
##########E##########
  ######## #        #
  ##       ######## #
  ########          #
           ##########
# ###################
#           #########
# #########         #
# #         ####### #
###################S#
